8,1,193,0,0,241,255,0,0,0,169,1,0,0,0,0,0,0,96,0,0,0,0,0,0,0,0,0,0,0,0,0,0,0,0,0,0,0,0,0,0,0,0,0,0,0,0,0,0,0,0,0,0,0,0,0,0,0,0,0,0,0,0,0,0,0,0,130,243,3,0,4,0,0,0,0,0,0,0,0,0,0,24,12,0,0,0,0,0,0,0,0,0,0,0,0,0,0,0,0,0,0,0,0,0,0,0,0,0,0,0,0,0,0,0,0,0,0,0,0,0,0,0,0,0,0,0,0,0,0,0,0,0,0,0,0,0,0,0,0,0,0,0,0,0,0,0,0,0,0,0,0,0,0,0,0,0,0,0,0,0,0,0,0,0,0,0,0,0,52,86,0,0,0,0,240,1,208,12,0,0,24,2,72,0,144,23,0,0,8,0,168,1,224,76,152,1,120,77,172,0,154,74,112,206,0,0,0,0,0,0,0,0,32,9,64,32,0,0,0,0,0,0,0,0,0,0,0,0,197,4,40,4,188,4,226,3,3,0,226,2,6,0,98,3,162,86,0
8,1,193,1,0,241,0,1,0,0,169,1,0,0,0,0,0,0,96,0,0,0,0,0,0,0,0,0,0,0,0,0,0,0,0,0,0,0,0,0,0,0,0,0,0,0,0,0,0,0,0,0,0,0,0,0,0,0,0,0,0,0,0,0,0,0,0,129,243,3,0,4,0,0,0,0,0,0,0,0,0,0,24,12,0,0,0,0,0,0,0,0,0,0,0,0,0,0,0,0,0,0,0,0,0,0,0,0,0,0,0,0,0,0,0,0,0,0,0,0,0,0,0,0,0,0,0,0,0,0,0,0,0,0,0,0,0,0,0,0,0,0,0,0,0,0,0,0,0,0,0,0,0,0,0,0,0,0,0,0,0,0,0,0,0,0,0,0,0,52,86,0,0,0,0,240,1,216,12,0,0,24,2,72,0,136,23,0,0,0,0,168,1,224,76,152,1,120,77,173,0,153,74,128,206,0,0,0,0,0,0,0,0,48,9,64,32,0,0,0,0,0,0,0,0,0,0,0,0,197,4,39,4,188,4,226,3,5,0,225,2,5,0,97,3,162,86,0
8,1,193,2,0,241,1,1,0,0,169,1,0,0,0,0,0,0,96,0,0,0,0,0,0,0,0,0,0,0,0,0,0,0,0,0,0,0,0,0,0,0,0,0,0,0,0,0,0,0,0,0,0,0,0,0,0,0,0,0,0,0,0,0,0,0,0,128,243,3,0,4,0,0,0,0,0,0,0,0,0,0,24,12,0,0,0,0,0,0,0,0,0,0,0,0,0,0,0,0,0,0,0,0,0,0,0,0,0,0,0,0,0,0,0,0,0,0,0,0,0,0,0,0,0,0,0,0,0,0,0,0,0,0,0,0,0,0,0,0,0,0,0,0,0,0,0,0,0,0,0,0,0,0,0,0,0,0,0,0,0,0,0,0,0,0,0,0,0,52,86,0,0,0,0,240,1,216,12,0,0,24,2,72,0,144,23,0,0,8,0,168,1,224,76,160,1,120,77,175,0,154,74,112,206,0,0,0,0,0,0,0,0,64,9,64,32,0,0,0,0,0,0,0,0,0,0,0,0,197,4,40,4,189,4,224,3,5,0,224,2,5,0,97,3,162,86,0
8,1,193,3,0,241,2,1,0,0,169,1,0,0,0,0,0,0,96,0,0,0,0,0,0,0,0,0,0,0,0,0,0,0,0,0,0,0,0,0,0,0,0,0,0,0,0,0,0,0,0,0,0,0,0,0,0,0,0,0,0,0,0,0,0,0,0,127,243,3,0,4,0,0,0,0,0,0,0,0,0,0,24,12,0,0,0,0,0,0,0,0,0,0,0,0,0,0,0,0,0,0,0,0,0,0,0,0,0,0,0,0,0,0,0,0,0,0,0,0,0,0,0,0,0,0,0,0,0,0,0,0,0,0,0,0,0,0,0,0,0,0,0,0,0,0,0,0,0,0,0,0,0,0,0,0,0,0,0,0,0,0,0,0,0,0,0,0,0,52,86,0,0,0,0,240,1,208,12,0,0,24,2,72,0,144,23,0,0,0,0,176,1,232,76,160,1,120,77,176,0,155,74,144,206,0,0,0,0,0,0,0,0,72,9,64,32,0,0,0,0,0,0,0,0,0,0,0,0,197,4,39,4,188,4,223,3,6,0,223,2,5,0,96,3,162,86,0
8,1,193,4,0,241,3,1,0,0,169,1,0,0,0,0,0,0,96,0,0,0,0,0,0,0,0,0,0,0,0,0,0,0,0,0,0,0,0,0,0,0,0,0,0,0,0,0,0,0,0,0,0,0,0,0,0,0,0,0,0,0,0,0,0,0,0,126,243,3,0,4,0,0,0,0,0,0,0,0,0,0,24,12,0,0,0,0,0,0,0,0,0,0,0,0,0,0,0,0,0,0,0,0,0,0,0,0,0,0,0,0,0,0,0,0,0,0,0,0,0,0,0,0,0,0,0,0,0,0,0,0,0,0,0,0,0,0,0,0,0,0,0,0,0,0,0,0,0,0,0,0,0,0,0,0,0,0,0,0,0,0,0,0,0,0,0,0,0,52,86,0,0,0,0,240,1,216,12,0,0,24,2,72,0,144,23,0,0,8,0,176,1,224,76,160,1,120,77,175,0,156,74,144,206,0,0,0,0,0,0,0,0,72,9,64,32,0,0,0,0,0,0,0,0,0,0,0,0,198,4,38,4,189,4,224,3,5,0,221,2,5,0,95,3,162,86,0
8,1,193,5,0,241,4,1,0,0,169,1,0,0,0,0,0,0,96,0,0,0,0,0,0,0,0,0,0,0,0,0,0,0,0,0,0,0,0,0,0,0,0,0,0,0,0,0,0,0,0,0,0,0,0,0,0,0,0,0,0,0,0,0,0,0,0,125,243,3,0,4,0,0,0,0,0,0,0,0,0,0,24,12,0,0,0,0,0,0,0,0,0,0,0,0,0,0,0,0,0,0,0,0,0,0,0,0,0,0,0,0,0,0,0,0,0,0,0,0,0,0,0,0,0,0,0,0,0,0,0,0,0,0,0,0,0,0,0,0,0,0,0,0,0,0,0,0,0,0,0,0,0,0,0,0,0,0,0,0,0,0,0,0,0,0,0,0,0,52,86,0,0,0,0,240,1,216,12,0,0,24,2,72,0,144,23,0,0,0,0,176,1,224,76,160,1,120,77,177,0,155,74,160,206,0,0,0,0,0,0,0,0,80,9,64,32,0,0,0,0,0,0,0,0,0,0,0,0,196,4,38,4,187,4,223,3,5,0,221,2,5,0,95,3,162,86,0
8,1,193,6,0,241,5,1,0,0,169,1,0,0,0,0,0,0,96,0,0,0,0,0,0,0,0,0,0,0,0,0,0,0,0,0,0,0,0,0,0,0,0,0,0,0,0,0,0,0,0,0,0,0,0,0,0,0,0,0,0,0,0,0,0,0,0,124,243,3,0,4,0,0,0,0,0,0,0,0,0,0,24,12,0,0,0,0,0,0,0,0,0,0,0,0,0,0,0,0,0,0,0,0,0,0,0,0,0,0,0,0,0,0,0,0,0,0,0,0,0,0,0,0,0,0,0,0,0,0,0,0,0,0,0,0,0,0,0,0,0,0,0,0,0,0,0,0,0,0,0,0,0,0,0,0,0,0,0,0,0,0,0,0,0,0,0,0,0,52,86,0,0,0,0,240,1,216,12,0,0,24,2,72,0,144,23,0,0,0,0,176,1,232,76,160,1,120,77,177,0,156,74,144,206,0,0,0,0,0,0,0,0,80,9,64,32,0,0,0,0,0,0,0,0,0,0,0,0,196,4,37,4,187,4,222,3,4,0,220,2,6,0,95,3,162,86,0
8,1,193,7,0,241,6,1,0,0,169,1,0,0,0,0,0,0,96,0,0,0,0,0,0,0,0,0,0,0,0,0,0,0,0,0,0,0,0,0,0,0,0,0,0,0,0,0,0,0,0,0,0,0,0,0,0,0,0,0,0,0,0,0,0,0,0,123,243,3,0,4,0,0,0,0,0,0,0,0,0,0,24,12,0,0,0,0,0,0,0,0,0,0,0,0,0,0,0,0,0,0,0,0,0,0,0,0,0,0,0,0,0,0,0,0,0,0,0,0,0,0,0,0,0,0,0,0,0,0,0,0,0,0,0,0,0,0,0,0,0,0,0,0,0,0,0,0,0,0,0,0,0,0,0,0,0,0,0,0,0,0,0,0,0,0,0,0,0,52,86,0,0,0,0,248,1,216,12,0,0,24,2,72,0,136,23,0,0,0,0,176,1,224,76,152,1,120,77,177,0,156,74,144,206,0,0,0,0,0,0,0,0,88,9,72,32,0,0,0,0,0,0,0,0,0,0,0,0,196,4,37,4,187,4,223,3,7,0,218,2,3,0,93,3,162,86,0
8,1,193,8,0,241,7,1,0,0,169,1,0,0,0,0,0,0,96,0,0,0,0,0,0,0,0,0,0,0,0,0,0,0,0,0,0,0,0,0,0,0,0,0,0,0,0,0,0,0,0,0,0,0,0,0,0,0,0,0,0,0,0,0,0,0,0,122,243,3,0,4,0,0,0,0,0,0,0,0,0,0,24,12,0,0,0,0,0,0,0,0,0,0,0,0,0,0,0,0,0,0,0,0,0,0,0,0,0,0,0,0,0,0,0,0,0,0,0,0,0,0,0,0,0,0,0,0,0,0,0,0,0,0,0,0,0,0,0,0,0,0,0,0,0,0,0,0,0,0,0,0,0,0,0,0,0,0,0,0,0,0,0,0,0,0,0,0,0,52,86,0,0,0,0,240,1,216,12,0,0,24,2,72,0,136,23,0,0,0,0,176,1,232,76,160,1,120,77,177,0,158,74,176,206,0,0,0,0,0,0,0,0,96,9,72,32,0,0,0,0,0,0,0,0,0,0,0,0,197,4,38,4,187,4,222,3,6,0,218,2,3,0,93,3,162,86,0
8,1,193,9,0,241,8,1,0,0,169,1,0,0,0,0,0,0,96,0,0,0,0,0,0,0,0,0,0,0,0,0,0,0,0,0,0,0,0,0,0,0,0,0,0,0,0,0,0,0,0,0,0,0,0,0,0,0,0,0,0,0,0,0,0,0,0,121,243,3,0,4,0,0,0,0,0,0,0,0,0,0,24,12,0,0,0,0,0,0,0,0,0,0,0,0,0,0,0,0,0,0,0,0,0,0,0,0,0,0,0,0,0,0,0,0,0,0,0,0,0,0,0,0,0,0,0,0,0,0,0,0,0,0,0,0,0,0,0,0,0,0,0,0,0,0,0,0,0,0,0,0,0,0,0,0,0,0,0,0,0,0,0,0,0,0,0,0,0,52,86,0,0,0,0,240,1,208,12,0,0,24,2,72,0,144,23,0,0,8,0,176,1,232,76,160,1,120,77,177,0,156,74,160,206,0,0,0,0,0,0,0,0,96,9,72,32,0,0,0,0,0,0,0,0,0,0,0,0,196,4,36,4,188,4,222,3,6,0,217,2,3,0,92,3,162,86,0
8,1,193,10,0,241,9,1,0,0,169,1,0,0,0,0,0,0,96,0,0,0,0,0,0,0,0,0,0,0,0,0,0,0,0,0,0,0,0,0,0,0,0,0,0,0,0,0,0,0,0,0,0,0,0,0,0,0,0,0,0,0,0,0,0,0,0,120,243,3,0,4,0,0,0,0,0,0,0,0,0,0,24,12,0,0,0,0,0,0,0,0,0,0,0,0,0,0,0,0,0,0,0,0,0,0,0,0,0,0,0,0,0,0,0,0,0,0,0,0,0,0,0,0,0,0,0,0,0,0,0,0,0,0,0,0,0,0,0,0,0,0,0,0,0,0,0,0,0,0,0,0,0,0,0,0,0,0,0,0,0,0,0,0,0,0,0,0,0,52,86,0,0,0,0,240,1,216,12,0,0,24,2,72,0,144,23,0,0,8,0,176,1,224,76,160,1,120,77,176,0,156,74,160,206,0,0,0,0,0,0,0,0,88,9,64,32,0,0,0,0,0,0,0,0,0,0,0,0,197,4,35,4,187,4,221,3,3,0,216,2,4,0,91,3,162,86,0
8,1,193,11,0,241,10,1,0,0,169,1,0,0,0,0,0,0,96,0,0,0,0,0,0,0,0,0,0,0,0,0,0,0,0,0,0,0,0,0,0,0,0,0,0,0,0,0,0,0,0,0,0,0,0,0,0,0,0,0,0,0,0,0,0,0,0,119,243,3,0,4,0,0,0,0,0,0,0,0,0,0,24,12,0,0,0,0,0,0,0,0,0,0,0,0,0,0,0,0,0,0,0,0,0,0,0,0,0,0,0,0,0,0,0,0,0,0,0,0,0,0,0,0,0,0,0,0,0,0,0,0,0,0,0,0,0,0,0,0,0,0,0,0,0,0,0,0,0,0,0,0,0,0,0,0,0,0,0,0,0,0,0,0,0,0,0,0,0,52,86,0,0,0,0,248,1,216,12,0,0,24,2,72,0,144,23,0,0,8,0,176,1,224,76,152,1,120,77,176,0,156,74,160,206,0,0,0,0,0,0,0,0,80,9,64,32,0,0,0,0,0,0,0,0,0,0,0,0,197,4,36,4,188,4,221,3,6,0,214,2,5,0,90,3,162,86,0
8,1,193,12,0,241,11,1,0,0,169,1,0,0,0,0,0,0,96,0,0,0,0,0,0,0,0,0,0,0,0,0,0,0,0,0,0,0,0,0,0,0,0,0,0,0,0,0,0,0,0,0,0,0,0,0,0,0,0,0,0,0,0,0,0,0,0,118,243,3,0,4,0,0,0,0,0,0,0,0,0,0,24,12,0,0,0,0,0,0,0,0,0,0,0,0,0,0,0,0,0,0,0,0,0,0,0,0,0,0,0,0,0,0,0,0,0,0,0,0,0,0,0,0,0,0,0,0,0,0,0,0,0,0,0,0,0,0,0,0,0,0,0,0,0,0,0,0,0,0,0,0,0,0,0,0,0,0,0,0,0,0,0,0,0,0,0,0,0,52,86,0,0,0,0,240,1,216,12,0,0,24,2,72,0,144,23,0,0,8,0,176,1,224,76,160,1,120,77,177,0,155,74,160,206,0,0,0,0,0,0,0,0,80,9,64,32,0,0,0,0,0,0,0,0,0,0,0,0,196,4,35,4,186,4,219,3,5,0,213,2,3,0,90,3,162,86,0
8,1,193,13,0,241,12,1,0,0,169,1,0,0,0,0,0,0,96,0,0,0,0,0,0,0,0,0,0,0,0,0,0,0,0,0,0,0,0,0,0,0,0,0,0,0,0,0,0,0,0,0,0,0,0,0,0,0,0,0,0,0,0,0,0,0,0,117,243,3,0,4,0,0,0,0,0,0,0,0,0,0,24,12,0,0,0,0,0,0,0,0,0,0,0,0,0,0,0,0,0,0,0,0,0,0,0,0,0,0,0,0,0,0,0,0,0,0,0,0,0,0,0,0,0,0,0,0,0,0,0,0,0,0,0,0,0,0,0,0,0,0,0,0,0,0,0,0,0,0,0,0,0,0,0,0,0,0,0,0,0,0,0,0,0,0,0,0,0,52,86,0,0,0,0,240,1,216,12,0,0,24,2,72,0,136,23,0,0,0,0,176,1,224,76,160,1,120,77,177,0,157,74,160,206,0,0,0,0,0,0,0,0,96,9,72,32,0,0,0,0,0,0,0,0,0,0,0,0,197,4,35,4,187,4,219,3,5,0,212,2,4,0,88,3,162,86,0
8,1,193,14,0,241,13,1,0,0,169,1,0,0,0,0,0,0,96,0,0,0,0,0,0,0,0,0,0,0,0,0,0,0,0,0,0,0,0,0,0,0,0,0,0,0,0,0,0,0,0,0,0,0,0,0,0,0,0,0,0,0,0,0,0,0,0,116,243,3,0,4,0,0,0,0,0,0,0,0,0,0,24,12,0,0,0,0,0,0,0,0,0,0,0,0,0,0,0,0,0,0,0,0,0,0,0,0,0,0,0,0,0,0,0,0,0,0,0,0,0,0,0,0,0,0,0,0,0,0,0,0,0,0,0,0,0,0,0,0,0,0,0,0,0,0,0,0,0,0,0,0,0,0,0,0,0,0,0,0,0,0,0,0,0,0,0,0,0,52,86,0,0,0,0,240,1,216,12,0,0,24,2,72,0,144,23,0,0,8,0,176,1,224,76,160,1,120,77,177,0,156,74,176,206,0,0,0,0,0,0,0,0,96,9,72,32,0,0,0,0,0,0,0,0,0,0,0,0,197,4,35,4,186,4,219,3,5,0,211,2,6,0,88,3,162,86,0
8,1,193,15,0,241,14,1,0,0,169,1,0,0,0,0,0,0,96,0,0,0,0,0,0,0,0,0,0,0,0,0,0,0,0,0,0,0,0,0,0,0,0,0,0,0,0,0,0,0,0,0,0,0,0,0,0,0,0,0,0,0,0,0,0,0,0,115,243,3,0,4,0,0,0,0,0,0,0,0,0,0,24,12,0,0,0,0,0,0,0,0,0,0,0,0,0,0,0,0,0,0,0,0,0,0,0,0,0,0,0,0,0,0,0,0,0,0,0,0,0,0,0,0,0,0,0,0,0,0,0,0,0,0,0,0,0,0,0,0,0,0,0,0,0,0,0,0,0,0,0,0,0,0,0,0,0,0,0,0,0,0,0,0,0,0,0,0,0,52,86,0,0,0,0,248,1,216,12,0,0,24,2,72,0,144,23,0,0,8,0,176,1,232,76,160,1,120,77,177,0,158,74,176,206,0,0,0,0,0,0,0,0,96,9,72,32,0,0,0,0,0,0,0,0,0,0,0,0,195,4,35,4,188,4,217,3,5,0,210,2,5,0,86,3,162,86,0
8,1,193,16,0,241,15,1,0,0,169,1,0,0,0,0,0,0,96,0,0,0,0,0,0,0,0,0,0,0,0,0,0,0,0,0,0,0,0,0,0,0,0,0,0,0,0,0,0,0,0,0,0,0,0,0,0,0,0,0,0,0,0,0,0,0,0,114,243,3,0,4,0,0,0,0,0,0,0,0,0,0,24,12,0,0,0,0,0,0,0,0,0,0,0,0,0,0,0,0,0,0,0,0,0,0,0,0,0,0,0,0,0,0,0,0,0,0,0,0,0,0,0,0,0,0,0,0,0,0,0,0,0,0,0,0,0,0,0,0,0,0,0,0,0,0,0,0,0,0,0,0,0,0,0,0,0,0,0,0,0,0,0,0,0,0,0,0,0,88,86,0,0,0,0,248,1,216,12,0,0,24,2,72,0,144,23,0,0,8,0,176,1,232,76,160,1,120,77,177,0,156,74,176,206,0,0,0,0,0,0,0,0,96,9,72,32,0,0,0,0,0,0,0,0,0,0,0,0,195,4,34,4,187,4,218,3,5,0,210,2,4,0,86,3,199,86,0
8,1,193,17,0,241,16,1,0,0,169,1,0,0,0,0,0,0,96,0,0,0,0,0,0,0,0,0,0,0,0,0,0,0,0,0,0,0,0,0,0,0,0,0,0,0,0,0,0,0,0,0,0,0,0,0,0,0,0,0,0,0,0,0,0,0,0,113,243,3,0,4,0,0,0,0,0,0,0,0,0,0,24,12,0,0,0,0,0,0,0,0,0,0,0,0,0,0,0,0,0,0,0,0,0,0,0,0,0,0,0,0,0,0,0,0,0,0,0,0,0,0,0,0,0,0,0,0,0,0,0,0,0,0,0,0,0,0,0,0,0,0,0,0,0,0,0,0,0,0,0,0,0,0,0,0,0,0,0,0,0,0,0,0,0,0,0,0,0,88,86,0,0,0,0,240,1,216,12,0,0,24,2,72,0,144,23,0,0,0,0,176,1,224,76,160,1,120,77,177,0,158,74,176,206,0,0,0,0,0,0,0,0,96,9,72,32,0,0,0,0,0,0,0,0,0,0,0,0,196,4,34,4,186,4,218,3,4,0,208,2,6,0,86,3,199,86,0
8,1,193,18,0,241,17,1,0,0,169,1,0,0,0,0,0,0,96,0,0,0,0,0,0,0,0,0,0,0,0,0,0,0,0,0,0,0,0,0,0,0,0,0,0,0,0,0,0,0,0,0,0,0,0,0,0,0,0,0,0,0,0,0,0,0,0,112,243,3,0,4,0,0,0,0,0,0,0,0,0,0,24,12,0,0,0,0,0,0,0,0,0,0,0,0,0,0,0,0,0,0,0,0,0,0,0,0,0,0,0,0,0,0,0,0,0,0,0,0,0,0,0,0,0,0,0,0,0,0,0,0,0,0,0,0,0,0,0,0,0,0,0,0,0,0,0,0,0,0,0,0,0,0,0,0,0,0,0,0,0,0,0,0,0,0,0,0,0,88,86,0,0,0,0,240,1,216,12,0,0,24,2,72,0,144,23,0,0,8,0,176,1,224,76,160,1,120,77,178,0,157,74,176,206,0,0,0,0,0,0,0,0,104,9,72,32,0,0,0,0,0,0,0,0,0,0,0,0,194,4,32,4,185,4,217,3,3,0,207,2,6,0,83,3,199,86,0
8,1,193,19,0,241,18,1,0,0,169,1,0,0,0,0,0,0,96,0,0,0,0,0,0,0,0,0,0,0,0,0,0,0,0,0,0,0,0,0,0,0,0,0,0,0,0,0,0,0,0,0,0,0,0,0,0,0,0,0,0,0,0,0,0,0,0,111,243,3,0,4,0,0,0,0,0,0,0,0,0,0,24,12,0,0,0,0,0,0,0,0,0,0,0,0,0,0,0,0,0,0,0,0,0,0,0,0,0,0,0,0,0,0,0,0,0,0,0,0,0,0,0,0,0,0,0,0,0,0,0,0,0,0,0,0,0,0,0,0,0,0,0,0,0,0,0,0,0,0,0,0,0,0,0,0,0,0,0,0,0,0,0,0,0,0,0,0,0,88,86,0,0,0,0,240,1,216,12,0,0,24,2,72,0,144,23,0,0,0,0,176,1,232,76,160,1,120,77,180,0,159,74,176,206,0,0,0,0,0,0,0,0,112,9,72,32,0,0,0,0,0,0,0,0,0,0,0,0,195,4,34,4,187,4,215,3,5,0,206,2,5,0,83,3,199,86,0
8,1,193,20,0,241,19,1,0,0,169,1,0,0,0,0,0,0,96,0,0,0,0,0,0,0,0,0,0,0,0,0,0,0,0,0,0,0,0,0,0,0,0,0,0,0,0,0,0,0,0,0,0,0,0,0,0,0,0,0,0,0,0,0,0,0,0,110,243,3,0,4,0,0,0,0,0,0,0,0,0,0,24,12,0,0,0,0,0,0,0,0,0,0,0,0,0,0,0,0,0,0,0,0,0,0,0,0,0,0,0,0,0,0,0,0,0,0,0,0,0,0,0,0,0,0,0,0,0,0,0,0,0,0,0,0,0,0,0,0,0,0,0,0,0,0,0,0,0,0,0,0,0,0,0,0,0,0,0,0,0,0,0,0,0,0,0,0,0,88,86,0,0,0,0,248,1,216,12,0,0,24,2,72,0,144,23,0,0,0,0,176,1,232,76,160,1,120,77,179,0,158,74,176,206,0,0,0,0,0,0,0,0,104,9,72,32,0,0,0,0,0,0,0,0,0,0,0,0,196,4,33,4,187,4,216,3,5,0,204,2,5,0,83,3,199,86,0
8,1,193,21,0,241,20,1,0,0,169,1,0,0,0,0,0,0,96,0,0,0,0,0,0,0,0,0,0,0,0,0,0,0,0,0,0,0,0,0,0,0,0,0,0,0,0,0,0,0,0,0,0,0,0,0,0,0,0,0,0,0,0,0,0,0,0,109,243,3,0,4,0,0,0,0,0,0,0,0,0,0,24,12,0,0,0,0,0,0,0,0,0,0,0,0,0,0,0,0,0,0,0,0,0,0,0,0,0,0,0,0,0,0,0,0,0,0,0,0,0,0,0,0,0,0,0,0,0,0,0,0,0,0,0,0,0,0,0,0,0,0,0,0,0,0,0,0,0,0,0,0,0,0,0,0,0,0,0,0,0,0,0,0,0,0,0,0,0,88,86,0,0,0,0,240,1,216,12,0,0,24,2,72,0,144,23,0,0,0,0,176,1,232,76,160,1,120,77,179,0,159,74,192,206,0,0,0,0,0,0,0,0,112,9,72,32,0,0,0,0,0,0,0,0,0,0,0,0,195,4,32,4,187,4,216,3,5,0,203,2,6,0,81,3,199,86,0
8,1,193,22,0,241,21,1,0,0,169,1,0,0,0,0,0,0,96,0,0,0,0,0,0,0,0,0,0,0,0,0,0,0,0,0,0,0,0,0,0,0,0,0,0,0,0,0,0,0,0,0,0,0,0,0,0,0,0,0,0,0,0,0,0,0,0,108,243,3,0,4,0,0,0,0,0,0,0,0,0,0,24,12,0,0,0,0,0,0,0,0,0,0,0,0,0,0,0,0,0,0,0,0,0,0,0,0,0,0,0,0,0,0,0,0,0,0,0,0,0,0,0,0,0,0,0,0,0,0,0,0,0,0,0,0,0,0,0,0,0,0,0,0,0,0,0,0,0,0,0,0,0,0,0,0,0,0,0,0,0,0,0,0,0,0,0,0,0,88,86,0,0,0,0,240,1,216,12,0,0,24,2,72,0,144,23,0,0,8,0,176,1,232,76,160,1,120,77,177,0,158,74,176,206,0,0,0,0,0,0,0,0,104,9,72,32,0,0,0,0,0,0,0,0,0,0,0,0,194,4,31,4,186,4,216,3,6,0,203,2,3,0,81,3,199,86,0
8,1,193,23,0,241,22,1,0,0,169,1,0,0,0,0,0,0,96,0,0,0,0,0,0,0,0,0,0,0,0,0,0,0,0,0,0,0,0,0,0,0,0,0,0,0,0,0,0,0,0,0,0,0,0,0,0,0,0,0,0,0,0,0,0,0,0,107,243,3,0,4,0,0,0,0,0,0,0,0,0,0,24,12,0,0,0,0,0,0,0,0,0,0,0,0,0,0,0,0,0,0,0,0,0,0,0,0,0,0,0,0,0,0,0,0,0,0,0,0,0,0,0,0,0,0,0,0,0,0,0,0,0,0,0,0,0,0,0,0,0,0,0,0,0,0,0,0,0,0,0,0,0,0,0,0,0,0,0,0,0,0,0,0,0,0,0,0,0,88,86,0,0,0,0,240,1,216,12,0,0,24,2,72,0,136,23,0,0,8,0,176,1,232,76,160,1,120,77,178,0,157,74,176,206,0,0,0,0,0,0,0,0,104,9,72,32,0,0,0,0,0,0,0,0,0,0,0,0,195,4,32,4,186,4,214,3,5,0,201,2,4,0,80,3,199,86,0
8,1,193,24,0,241,23,1,0,0,169,1,0,0,0,0,0,0,96,0,0,0,0,0,0,0,0,0,0,0,0,0,0,0,0,0,0,0,0,0,0,0,0,0,0,0,0,0,0,0,0,0,0,0,0,0,0,0,0,0,0,0,0,0,0,0,0,106,243,3,0,4,0,0,0,0,0,0,0,0,0,0,24,12,0,0,0,0,0,0,0,0,0,0,0,0,0,0,0,0,0,0,0,0,0,0,0,0,0,0,0,0,0,0,0,0,0,0,0,0,0,0,0,0,0,0,0,0,0,0,0,0,0,0,0,0,0,0,0,0,0,0,0,0,0,0,0,0,0,0,0,0,0,0,0,0,0,0,0,0,0,0,0,0,0,0,0,0,0,88,86,0,0,0,0,248,1,216,12,0,0,24,2,72,0,144,23,0,0,0,0,176,1,232,76,160,1,128,77,178,0,159,74,192,206,0,0,0,0,0,0,0,0,104,9,72,32,0,0,0,0,0,0,0,0,0,0,0,0,195,4,31,4,185,4,213,3,6,0,200,2,3,0,80,3,199,86,0
8,1,193,25,0,241,24,1,0,0,169,1,0,0,0,0,0,0,96,0,0,0,0,0,0,0,0,0,0,0,0,0,0,0,0,0,0,0,0,0,0,0,0,0,0,0,0,0,0,0,0,0,0,0,0,0,0,0,0,0,0,0,0,0,0,0,0,105,243,3,0,4,0,0,0,0,0,0,0,0,0,0,24,12,0,0,0,0,0,0,0,0,0,0,0,0,0,0,0,0,0,0,0,0,0,0,0,0,0,0,0,0,0,0,0,0,0,0,0,0,0,0,0,0,0,0,0,0,0,0,0,0,0,0,0,0,0,0,0,0,0,0,0,0,0,0,0,0,0,0,0,0,0,0,0,0,0,0,0,0,0,0,0,0,0,0,0,0,0,88,86,0,0,0,0,240,1,216,12,0,0,24,2,72,0,136,23,0,0,0,0,176,1,232,76,160,1,120,77,177,0,157,74,160,206,0,0,0,0,0,0,0,0,96,9,72,32,0,0,0,0,0,0,0,0,0,0,0,0,195,4,32,4,184,4,213,3,5,0,199,2,4,0,79,3,199,86,0
8,1,193,26,0,241,25,1,0,0,169,1,0,0,0,0,0,0,96,0,0,0,0,0,0,0,0,0,0,0,0,0,0,0,0,0,0,0,0,0,0,0,0,0,0,0,0,0,0,0,0,0,0,0,0,0,0,0,0,0,0,0,0,0,0,0,0,104,243,3,0,4,0,0,0,0,0,0,0,0,0,0,24,12,0,0,0,0,0,0,0,0,0,0,0,0,0,0,0,0,0,0,0,0,0,0,0,0,0,0,0,0,0,0,0,0,0,0,0,0,0,0,0,0,0,0,0,0,0,0,0,0,0,0,0,0,0,0,0,0,0,0,0,0,0,0,0,0,0,0,0,0,0,0,0,0,0,0,0,0,0,0,0,0,0,0,0,0,0,88,86,0,0,0,0,240,1,216,12,0,0,24,2,72,0,144,23,0,0,8,0,176,1,224,76,160,1,120,77,177,0,158,74,176,206,0,0,0,0,0,0,0,0,104,9,72,32,0,0,0,0,0,0,0,0,0,0,0,0,195,4,32,4,184,4,214,3,5,0,199,2,6,0,78,3,199,86,0
8,1,193,27,0,241,26,1,0,0,169,1,0,0,0,0,0,0,96,0,0,0,0,0,0,0,0,0,0,0,0,0,0,0,0,0,0,0,0,0,0,0,0,0,0,0,0,0,0,0,0,0,0,0,0,0,0,0,0,0,0,0,0,0,0,0,0,103,243,3,0,4,0,0,0,0,0,0,0,0,0,0,24,12,0,0,0,0,0,0,0,0,0,0,0,0,0,0,0,0,0,0,0,0,0,0,0,0,0,0,0,0,0,0,0,0,0,0,0,0,0,0,0,0,0,0,0,0,0,0,0,0,0,0,0,0,0,0,0,0,0,0,0,0,0,0,0,0,0,0,0,0,0,0,0,0,0,0,0,0,0,0,0,0,0,0,0,0,0,88,86,0,0,0,0,240,1,216,12,0,0,24,2,72,0,136,23,0,0,0,0,176,1,224,76,160,1,120,77,178,0,157,74,192,206,0,0,0,0,0,0,0,0,104,9,72,32,0,0,0,0,0,0,0,0,0,0,0,0,195,4,30,4,186,4,212,3,5,0,198,2,6,0,78,3,199,86,0
8,1,193,28,0,241,27,1,0,0,169,1,0,0,0,0,0,0,96,0,0,0,0,0,0,0,0,0,0,0,0,0,0,0,0,0,0,0,0,0,0,0,0,0,0,0,0,0,0,0,0,0,0,0,0,0,0,0,0,0,0,0,0,0,0,0,0,102,243,3,0,4,0,0,0,0,0,0,0,0,0,0,24,12,0,0,0,0,0,0,0,0,0,0,0,0,0,0,0,0,0,0,0,0,0,0,0,0,0,0,0,0,0,0,0,0,0,0,0,0,0,0,0,0,0,0,0,0,0,0,0,0,0,0,0,0,0,0,0,0,0,0,0,0,0,0,0,0,0,0,0,0,0,0,0,0,0,0,0,0,0,0,0,0,0,0,0,0,0,88,86,0,0,0,0,240,1,216,12,0,0,24,2,72,0,144,23,0,0,0,0,176,1,232,76,160,1,120,77,178,0,157,74,176,206,0,0,0,0,0,0,0,0,104,9,72,32,0,0,0,0,0,0,0,0,0,0,0,0,195,4,30,4,186,4,213,3,5,0,196,2,5,0,76,3,199,86,0
8,1,193,29,0,241,28,1,0,0,169,1,0,0,0,0,0,0,96,0,0,0,0,0,0,0,0,0,0,0,0,0,0,0,0,0,0,0,0,0,0,0,0,0,0,0,0,0,0,0,0,0,0,0,0,0,0,0,0,0,0,0,0,0,0,0,0,101,243,3,0,4,0,0,0,0,0,0,0,0,0,0,24,12,0,0,0,0,0,0,0,0,0,0,0,0,0,0,0,0,0,0,0,0,0,0,0,0,0,0,0,0,0,0,0,0,0,0,0,0,0,0,0,0,0,0,0,0,0,0,0,0,0,0,0,0,0,0,0,0,0,0,0,0,0,0,0,0,0,0,0,0,0,0,0,0,0,0,0,0,0,0,0,0,0,0,0,0,0,88,86,0,0,0,0,248,1,216,12,0,0,24,2,72,0,144,23,0,0,8,0,176,1,224,76,160,1,120,77,177,0,158,74,192,206,0,0,0,0,0,0,0,0,104,9,72,32,0,0,0,0,0,0,0,0,0,0,0,0,193,4,31,4,185,4,212,3,6,0,196,2,4,0,75,3,199,86,0
8,1,193,30,0,241,29,1,0,0,169,1,0,0,0,0,0,0,96,0,0,0,0,0,0,0,0,0,0,0,0,0,0,0,0,0,0,0,0,0,0,0,0,0,0,0,0,0,0,0,0,0,0,0,0,0,0,0,0,0,0,0,0,0,0,0,0,100,243,3,0,4,0,0,0,0,0,0,0,0,0,0,24,12,0,0,0,0,0,0,0,0,0,0,0,0,0,0,0,0,0,0,0,0,0,0,0,0,0,0,0,0,0,0,0,0,0,0,0,0,0,0,0,0,0,0,0,0,0,0,0,0,0,0,0,0,0,0,0,0,0,0,0,0,0,0,0,0,0,0,0,0,0,0,0,0,0,0,0,0,0,0,0,0,0,0,0,0,0,88,86,0,0,0,0,240,1,216,12,0,0,24,2,72,0,144,23,0,0,0,0,176,1,232,76,160,1,120,77,176,0,157,74,208,206,0,0,0,0,0,0,0,0,104,9,72,32,0,0,0,0,0,0,0,0,0,0,0,0,193,4,30,4,186,4,211,3,5,0,194,2,4,0,75,3,199,86,0
8,1,193,31,0,241,30,1,0,0,169,1,0,0,0,0,0,0,96,0,0,0,0,0,0,0,0,0,0,0,0,0,0,0,0,0,0,0,0,0,0,0,0,0,0,0,0,0,0,0,0,0,0,0,0,0,0,0,0,0,0,0,0,0,0,0,0,99,243,3,0,4,0,0,0,0,0,0,0,0,0,0,24,12,0,0,0,0,0,0,0,0,0,0,0,0,0,0,0,0,0,0,0,0,0,0,0,0,0,0,0,0,0,0,0,0,0,0,0,0,0,0,0,0,0,0,0,0,0,0,0,0,0,0,0,0,0,0,0,0,0,0,0,0,0,0,0,0,0,0,0,0,0,0,0,0,0,0,0,0,0,0,0,0,0,0,0,0,0,88,86,0,0,0,0,240,1,216,12,0,0,24,2,72,0,144,23,0,0,8,0,176,1,232,76,160,1,120,77,177,0,156,74,176,206,0,0,0,0,0,0,0,0,96,9,72,32,0,0,0,0,0,0,0,0,0,0,0,0,194,4,29,4,186,4,212,3,5,0,194,2,4,0,75,3,199,86,0
8,1,193,32,0,241,31,1,0,0,169,1,0,0,0,0,0,0,96,0,0,0,0,0,0,0,0,0,0,0,0,0,0,0,0,0,0,0,0,0,0,0,0,0,0,0,0,0,0,0,0,0,0,0,0,0,0,0,0,0,0,0,0,0,0,0,0,98,243,3,0,4,0,0,0,0,0,0,0,0,0,0,24,12,0,0,0,0,0,0,0,0,0,0,0,0,0,0,0,0,0,0,0,0,0,0,0,0,0,0,0,0,0,0,0,0,0,0,0,0,0,0,0,0,0,0,0,0,0,0,0,0,0,0,0,0,0,0,0,0,0,0,0,0,0,0,0,0,0,0,0,0,0,0,0,0,0,0,0,0,0,0,0,0,0,0,0,0,0,88,86,0,0,0,0,240,1,216,12,0,0,24,2,72,0,144,23,0,0,8,0,176,1,232,76,160,1,120,77,176,0,157,74,208,206,0,0,0,0,0,0,0,0,96,9,72,32,0,0,0,0,0,0,0,0,0,0,0,0,194,4,28,4,183,4,209,3,5,0,192,2,4,0,74,3,199,86,0
8,1,193,33,0,241,32,1,0,0,169,1,0,0,0,0,0,0,96,0,0,0,0,0,0,0,0,0,0,0,0,0,0,0,0,0,0,0,0,0,0,0,0,0,0,0,0,0,0,0,0,0,0,0,0,0,0,0,0,0,0,0,0,0,0,0,0,97,243,3,0,4,0,0,0,0,0,0,0,0,0,0,24,12,0,0,0,0,0,0,0,0,0,0,0,0,0,0,0,0,0,0,0,0,0,0,0,0,0,0,0,0,0,0,0,0,0,0,0,0,0,0,0,0,0,0,0,0,0,0,0,0,0,0,0,0,0,0,0,0,0,0,0,0,0,0,0,0,0,0,0,0,0,0,0,0,0,0,0,0,0,0,0,0,0,0,0,0,0,88,86,0,0,0,0,248,1,216,12,0,0,24,2,72,0,144,23,0,0,0,0,176,1,232,76,160,1,120,77,176,0,156,74,192,206,0,0,0,0,0,0,0,0,96,9,72,32,0,0,0,0,0,0,0,0,0,0,0,0,193,4,27,4,184,4,210,3,6,0,191,2,5,0,74,3,199,86,0
8,1,193,34,0,241,33,1,0,0,169,1,0,0,0,0,0,0,96,0,0,0,0,0,0,0,0,0,0,0,0,0,0,0,0,0,0,0,0,0,0,0,0,0,0,0,0,0,0,0,0,0,0,0,0,0,0,0,0,0,0,0,0,0,0,0,0,96,243,3,0,4,0,0,0,0,0,0,0,0,0,0,24,12,0,0,0,0,0,0,0,0,0,0,0,0,0,0,0,0,0,0,0,0,0,0,0,0,0,0,0,0,0,0,0,0,0,0,0,0,0,0,0,0,0,0,0,0,0,0,0,0,0,0,0,0,0,0,0,0,0,0,0,0,0,0,0,0,0,0,0,0,0,0,0,0,0,0,0,0,0,0,0,0,0,0,0,0,0,88,86,0,0,0,0,240,1,208,12,0,0,24,2,72,0,136,23,0,0,8,0,176,1,232,76,160,1,120,77,177,0,157,74,192,206,0,0,0,0,0,0,0,0,96,9,72,32,0,0,0,0,0,0,0,0,0,0,0,0,194,4,27,4,184,4,209,3,6,0,190,2,5,0,73,3,199,86,0
8,1,193,35,0,241,34,1,0,0,169,1,0,0,0,0,0,0,96,0,0,0,0,0,0,0,0,0,0,0,0,0,0,0,0,0,0,0,0,0,0,0,0,0,0,0,0,0,0,0,0,0,0,0,0,0,0,0,0,0,0,0,0,0,0,0,0,95,243,3,0,4,0,0,0,0,0,0,0,0,0,0,24,12,0,0,0,0,0,0,0,0,0,0,0,0,0,0,0,0,0,0,0,0,0,0,0,0,0,0,0,0,0,0,0,0,0,0,0,0,0,0,0,0,0,0,0,0,0,0,0,0,0,0,0,0,0,0,0,0,0,0,0,0,0,0,0,0,0,0,0,0,0,0,0,0,0,0,0,0,0,0,0,0,0,0,0,0,0,88,86,0,0,0,0,240,1,216,12,0,0,24,2,72,0,144,23,0,0,8,0,176,1,224,76,160,1,120,77,177,0,157,74,176,206,0,0,0,0,0,0,0,0,104,9,72,32,0,0,0,0,0,0,0,0,0,0,0,0,194,4,28,4,183,4,209,3,5,0,190,2,4,0,71,3,199,86,0
8,1,193,36,0,241,35,1,0,0,169,1,0,0,0,0,0,0,96,0,0,0,0,0,0,0,0,0,0,0,0,0,0,0,0,0,0,0,0,0,0,0,0,0,0,0,0,0,0,0,0,0,0,0,0,0,0,0,0,0,0,0,0,0,0,0,0,94,243,3,0,4,0,0,0,0,0,0,0,0,0,0,24,12,0,0,0,0,0,0,0,0,0,0,0,0,0,0,0,0,0,0,0,0,0,0,0,0,0,0,0,0,0,0,0,0,0,0,0,0,0,0,0,0,0,0,0,0,0,0,0,0,0,0,0,0,0,0,0,0,0,0,0,0,0,0,0,0,0,0,0,0,0,0,0,0,0,0,0,0,0,0,0,0,0,0,0,0,0,88,86,0,0,0,0,240,1,216,12,0,0,24,2,72,0,136,23,0,0,0,0,176,1,224,76,160,1,120,77,177,0,158,74,192,206,0,0,0,0,0,0,0,0,104,9,72,32,0,0,0,0,0,0,0,0,0,0,0,0,193,4,26,4,184,4,209,3,5,0,188,2,4,0,71,3,199,86,0
8,1,193,37,0,241,36,1,0,0,169,1,0,0,0,0,0,0,96,0,0,0,0,0,0,0,0,0,0,0,0,0,0,0,0,0,0,0,0,0,0,0,0,0,0,0,0,0,0,0,0,0,0,0,0,0,0,0,0,0,0,0,0,0,0,0,0,93,243,3,0,4,0,0,0,0,0,0,0,0,0,0,24,12,0,0,0,0,0,0,0,0,0,0,0,0,0,0,0,0,0,0,0,0,0,0,0,0,0,0,0,0,0,0,0,0,0,0,0,0,0,0,0,0,0,0,0,0,0,0,0,0,0,0,0,0,0,0,0,0,0,0,0,0,0,0,0,0,0,0,0,0,0,0,0,0,0,0,0,0,0,0,0,0,0,0,0,0,0,88,86,0,0,0,0,248,1,216,12,0,0,24,2,72,0,144,23,0,0,0,0,176,1,224,76,160,1,128,77,177,0,157,74,192,206,0,0,0,0,0,0,0,0,104,9,72,32,0,0,0,0,0,0,0,0,0,0,0,0,194,4,26,4,183,4,207,3,4,0,188,2,4,0,70,3,199,86,0
8,1,193,38,0,241,37,1,0,0,169,1,0,0,0,0,0,0,96,0,0,0,0,0,0,0,0,0,0,0,0,0,0,0,0,0,0,0,0,0,0,0,0,0,0,0,0,0,0,0,0,0,0,0,0,0,0,0,0,0,0,0,0,0,0,0,0,92,243,3,0,4,0,0,0,0,0,0,0,0,0,0,24,12,0,0,0,0,0,0,0,0,0,0,0,0,0,0,0,0,0,0,0,0,0,0,0,0,0,0,0,0,0,0,0,0,0,0,0,0,0,0,0,0,0,0,0,0,0,0,0,0,0,0,0,0,0,0,0,0,0,0,0,0,0,0,0,0,0,0,0,0,0,0,0,0,0,0,0,0,0,0,0,0,0,0,0,0,0,88,86,0,0,0,0,240,1,216,12,0,0,24,2,72,0,144,23,0,0,8,0,176,1,232,76,160,1,120,77,177,0,158,74,176,206,0,0,0,0,0,0,0,0,112,9,72,32,0,0,0,0,0,0,0,0,0,0,0,0,193,4,27,4,182,4,207,3,5,0,187,2,5,0,70,3,199,86,0
8,1,193,39,0,241,38,1,0,0,169,1,0,0,0,0,0,0,96,0,0,0,0,0,0,0,0,0,0,0,0,0,0,0,0,0,0,0,0,0,0,0,0,0,0,0,0,0,0,0,0,0,0,0,0,0,0,0,0,0,0,0,0,0,0,0,0,91,243,3,0,4,0,0,0,0,0,0,0,0,0,0,24,12,0,0,0,0,0,0,0,0,0,0,0,0,0,0,0,0,0,0,0,0,0,0,0,0,0,0,0,0,0,0,0,0,0,0,0,0,0,0,0,0,0,0,0,0,0,0,0,0,0,0,0,0,0,0,0,0,0,0,0,0,0,0,0,0,0,0,0,0,0,0,0,0,0,0,0,0,0,0,0,0,0,0,0,0,0,88,86,0,0,0,0,240,1,216,12,0,0,24,2,72,0,144,23,0,0,0,0,176,1,232,76,160,1,120,77,178,0,157,74,208,206,0,0,0,0,0,0,0,0,104,9,72,32,0,0,0,0,0,0,0,0,0,0,0,0,192,4,27,4,183,4,207,3,5,0,187,2,4,0,70,3,199,86,0
8,1,193,40,0,241,39,1,0,0,169,1,0,0,0,0,0,0,96,0,0,0,0,0,0,0,0,0,0,0,0,0,0,0,0,0,0,0,0,0,0,0,0,0,0,0,0,0,0,0,0,0,0,0,0,0,0,0,0,0,0,0,0,0,0,0,0,90,243,3,0,4,0,0,0,0,0,0,0,0,0,0,24,12,0,0,0,0,0,0,0,0,0,0,0,0,0,0,0,0,0,0,0,0,0,0,0,0,0,0,0,0,0,0,0,0,0,0,0,0,0,0,0,0,0,0,0,0,0,0,0,0,0,0,0,0,0,0,0,0,0,0,0,0,0,0,0,0,0,0,0,0,0,0,0,0,0,0,0,0,0,0,0,0,0,0,0,0,0,88,86,0,0,0,0,240,1,216,12,0,0,24,2,72,0,144,23,0,0,8,0,176,1,224,76,160,1,120,77,178,0,157,74,208,206,0,0,0,0,0,0,0,0,112,9,72,32,0,0,0,0,0,0,0,0,0,0,0,0,191,4,26,4,184,4,205,3,4,0,186,2,4,0,68,3,199,86,0
8,1,193,41,0,241,40,1,0,0,169,1,0,0,0,0,0,0,96,0,0,0,0,0,0,0,0,0,0,0,0,0,0,0,0,0,0,0,0,0,0,0,0,0,0,0,0,0,0,0,0,0,0,0,0,0,0,0,0,0,0,0,0,0,0,0,0,89,243,3,0,4,0,0,0,0,0,0,0,0,0,0,24,12,0,0,0,0,0,0,0,0,0,0,0,0,0,0,0,0,0,0,0,0,0,0,0,0,0,0,0,0,0,0,0,0,0,0,0,0,0,0,0,0,0,0,0,0,0,0,0,0,0,0,0,0,0,0,0,0,0,0,0,0,0,0,0,0,0,0,0,0,0,0,0,0,0,0,0,0,0,0,0,0,0,0,0,0,0,88,86,0,0,0,0,240,1,216,12,0,0,24,2,72,0,144,23,0,0,8,0,176,1,224,76,160,1,120,77,179,0,159,74,208,206,0,0,0,0,0,0,0,0,112,9,80,32,0,0,0,0,0,0,0,0,0,0,0,0,193,4,24,4,184,4,205,3,4,0,184,2,4,0,67,3,199,86,0
8,1,193,42,0,241,41,1,0,0,169,1,0,0,0,0,0,0,96,0,0,0,0,0,0,0,0,0,0,0,0,0,0,0,0,0,0,0,0,0,0,0,0,0,0,0,0,0,0,0,0,0,0,0,0,0,0,0,0,0,0,0,0,0,0,0,0,88,243,3,0,4,0,0,0,0,0,0,0,0,0,0,24,12,0,0,0,0,0,0,0,0,0,0,0,0,0,0,0,0,0,0,0,0,0,0,0,0,0,0,0,0,0,0,0,0,0,0,0,0,0,0,0,0,0,0,0,0,0,0,0,0,0,0,0,0,0,0,0,0,0,0,0,0,0,0,0,0,0,0,0,0,0,0,0,0,0,0,0,0,0,0,0,0,0,0,0,0,0,88,86,0,0,0,0,248,1,216,12,0,0,24,2,72,0,136,23,0,0,8,0,176,1,232,76,160,1,120,77,178,0,158,74,208,206,0,0,0,0,0,0,0,0,104,9,72,32,0,0,0,0,0,0,0,0,0,0,0,0,192,4,24,4,183,4,206,3,5,0,184,2,4,0,67,3,199,86,0
8,1,193,43,0,241,42,1,0,0,169,1,0,0,0,0,0,0,96,0,0,0,0,0,0,0,0,0,0,0,0,0,0,0,0,0,0,0,0,0,0,0,0,0,0,0,0,0,0,0,0,0,0,0,0,0,0,0,0,0,0,0,0,0,0,0,0,87,243,3,0,4,0,0,0,0,0,0,0,0,0,0,24,12,0,0,0,0,0,0,0,0,0,0,0,0,0,0,0,0,0,0,0,0,0,0,0,0,0,0,0,0,0,0,0,0,0,0,0,0,0,0,0,0,0,0,0,0,0,0,0,0,0,0,0,0,0,0,0,0,0,0,0,0,0,0,0,0,0,0,0,0,0,0,0,0,0,0,0,0,0,0,0,0,0,0,0,0,0,88,86,0,0,0,0,240,1,216,12,0,0,24,2,72,0,144,23,0,0,0,0,176,1,224,76,160,1,120,77,178,0,157,74,192,206,0,0,0,0,0,0,0,0,104,9,72,32,0,0,0,0,0,0,0,0,0,0,0,0,192,4,24,4,182,4,205,3,6,0,182,2,4,0,67,3,199,86,0
8,1,193,44,0,241,43,1,0,0,169,1,0,0,0,0,0,0,96,0,0,0,0,0,0,0,0,0,0,0,0,0,0,0,0,0,0,0,0,0,0,0,0,0,0,0,0,0,0,0,0,0,0,0,0,0,0,0,0,0,0,0,0,0,0,0,0,86,243,3,0,4,0,0,0,0,0,0,0,0,0,0,24,12,0,0,0,0,0,0,0,0,0,0,0,0,0,0,0,0,0,0,0,0,0,0,0,0,0,0,0,0,0,0,0,0,0,0,0,0,0,0,0,0,0,0,0,0,0,0,0,0,0,0,0,0,0,0,0,0,0,0,0,0,0,0,0,0,0,0,0,0,0,0,0,0,0,0,0,0,0,0,0,0,0,0,0,0,0,88,86,0,0,0,0,240,1,216,12,0,0,24,2,72,0,144,23,0,0,0,0,176,1,232,76,168,1,120,77,179,0,158,74,192,206,0,0,0,0,0,0,0,0,112,9,80,32,0,0,0,0,0,0,0,0,0,0,0,0,192,4,24,4,183,4,204,3,5,0,182,2,5,0,65,3,199,86,0
8,1,193,45,0,241,44,1,0,0,169,1,0,0,0,0,0,0,96,0,0,0,0,0,0,0,0,0,0,0,0,0,0,0,0,0,0,0,0,0,0,0,0,0,0,0,0,0,0,0,0,0,0,0,0,0,0,0,0,0,0,0,0,0,0,0,0,85,243,3,0,4,0,0,0,0,0,0,0,0,0,0,24,12,0,0,0,0,0,0,0,0,0,0,0,0,0,0,0,0,0,0,0,0,0,0,0,0,0,0,0,0,0,0,0,0,0,0,0,0,0,0,0,0,0,0,0,0,0,0,0,0,0,0,0,0,0,0,0,0,0,0,0,0,0,0,0,0,0,0,0,0,0,0,0,0,0,0,0,0,0,0,0,0,0,0,0,0,0,88,86,0,0,0,0,240,1,216,12,0,0,24,2,72,0,144,23,0,0,8,0,176,1,232,76,160,1,120,77,178,0,158,74,208,206,0,0,0,0,0,0,0,0,104,9,72,32,0,0,0,0,0,0,0,0,0,0,0,0,191,4,24,4,183,4,204,3,6,0,182,2,4,0,64,3,199,86,0
